1111111111111111111111
1111111111111111111111
1111111111111111111111
1111111111111111111111
110010000000C111111111
1100001111100111111111
11P0011E00000111111111
1111111111111111111111
1111111111111111111111
1111111111111111111111
