111111111111111
1000000000000C1
110001111111111
111000001111111
110011000000111
11C111001110011
111100001111011
111111100011011
11C0000000PEC11
111111111111111
