111111111111111
10P0000C0001111
100001111111111
111000001111111
1100110000C0111
110111001111111
111100001111111
111111100000011
110000EC0000111
111111111111111
