111111111111111
1E00000000000P1
101111111111101
100000000000001
100000000000001
101111111111101
1C1111001C00001
100000001000111
1C11111110000C1
111111111111111
