1111111111111111111111111111111111
1P00000000000C11111111111111111111
1100011111111111111111111111111111
1110000011111111111111111111111111
1100110000001111111111111111111111
11C1110011111111111111111111111111
1111000011111111111111111111111111
11111110000E0111111111111111111111
11C0000000000111111111111111111111
1111111111111111111111111111111111
