111111111111111
111111111111111
111111111111111
110010000000C11
110000111110011
11P00111E000011
111111111111111
111111111111111
111111111111111
111111111111111
