111111111111111
10P000000001111
100001111111111
111000C01111111
110011000000111
110111001111111
111100001111111
111111100000011
110000000000E11
111111111111111
