111111111111111
1P00000000000c1
110001111111111
111000001111111
110011000000111
11c111001111111
111100001111111
11111110000E011
11c000000000011
111111111111111
