111111111111111
10P000000001111
100001111111111
111000001111111
110011000000111
110111001111111
111100001111111
111111100000011
110000EC0000111
111111111111111
